Copyright	NN	copyright
2016	CD	@card@
MediaNews	NP	MediaNews
Group	NP	Group
,	,	,
Inc.	NP	Inc.
and	CC	and
Los	NP	Los
Angeles	NP	Angeles
Newspaper	NP	Newspaper
Group	NP	Group
,	,	,
Inc.	NP	Inc.
All	NP	All
Rights	NPS	Rights
Reserved	NP	Reserved
170	CD	@card@
of	IN	of
1405	CD	@card@
DOCUMENTS	NP	DOCUMENTS
San	NP	San
Gabriel	NP	Gabriel
Valley	NP	Valley
Tribune	NP	Tribune
(	(	(
California	NP	California
)	)	)
November	NP	November
22	CD	@card@
,	,	,
2016	CD	@card@
TuesdayToday	NN	TuesdayToday
in	IN	in
historySECTION	NN	historySECTION
:	:	:
A	DT	a
,	,	,
A	NP	A
;	:	;
Pg	NP	Pg
.	SENT	.
1LENGTH	NP	1LENGTH
:	:	:
445	CD	@card@
wordsABSTRACTHist	NN	wordsABSTRACTHist
11-22FULL	JJ	11-22FULL
TEXT1718English	NP	TEXT1718English
pirate	NN	pirate
Edward	NP	Edward
Teach	NP	Teach
-	:	-
better-known	JJ	better-known
as	IN	as
"	``	"
Blackbeard	NP	Blackbeard
"	''	"
-	:	-
was	VBD	be
killed	VVN	kill
during	IN	during
abattle	NN	abattle
off	IN	off
present-day	JJ	present-day
North	NP	North
Carolina.1914The	NP	Carolina.1914The
First	NP	First
Battle	NP	Battle
of	IN	of
Ypres	NP	Ypres
during	IN	during
World	NP	World
War	NP	War
I	PP	I
ended	VVD	end
with	IN	with
an	DT	an
Allied	NP	Allied
victoryagainst	NP	victoryagainst
Germany.1963John	NP	Germany.1963John
F.	NP	F.
Kennedy	NP	Kennedy
,	,	,
the	DT	the
35th	JJ	35th
President	NN	president
of	IN	of
the	DT	the
United	NP	United
States	NPS	States
,	,	,
was	VBD	be
shot	VVN	shoot
to	TO	to
deathduring	NN	deathduring
a	DT	a
motorcade	NN	motorcade
in	IN	in
Dallas	NP	Dallas
;	:	;
Texas	NP	Texas
Gov.	NP	Gov.
John	NP	John
B.	NP	B.
Connally	NP	Connally
,	,	,
riding	VVG	ride
in	IN	in
the	DT	the
samecar	NN	samecar
as	IN	as
Kennedy	NP	Kennedy
,	,	,
was	VBD	be
seriously	RB	seriously
wounded	VVN	wound
;	:	;
suspected	JJ	suspected
gunman	NN	gunman
Lee	NP	Lee
Harvey	NP	Harvey
Oswald	NP	Oswald
wasarrested.1955Comic	JJ	wasarrested.1955Comic
Shemp	NP	Shemp
Howard	NP	Howard
of	IN	of
"	``	"
Three	NP	Three
Stooges	NP	Stooges
"	''	"
fame	NN	fame
died	VVN	die
in	IN	in
Hollywood	NP	Hollywood
at	IN	at
age	NN	age
60.1965The	JJ	60.1965The
musical	NN	musical
"	''	"
Man	NN	man
of	IN	of
La	NP	La
Mancha	NP	Mancha
"	``	"
opened	VVD	open
on	IN	on
Broadway	NP	Broadway
.	SENT	.
Singer-songwriter	NN	singer-songwriter
Bob	NP	Bob
Dylanmarried	NP	Dylanmarried
Sara	NP	Sara
Lownds	NP	Lownds
(	(	(
the	DT	the
marriage	NN	marriage
lasted	VVD	last
12	CD	@card@
years).1975Juan	NP	years).1975Juan
Carlos	NP	Carlos
was	VBD	be
proclaimed	VVN	proclaim
King	NP	King
of	IN	of
Spain.1989Rene	NP	Spain.1989Rene
Mouawad	NP	Mouawad
was	VBD	be
killed	VVN	kill
by	IN	by
a	DT	a
bomb	NN	bomb
after	IN	after
serving	VVG	serve
17	CD	@card@
days	NNS	day
as	IN	as
president	NN	president
of	IN	of
Lebanon.1990British	NP	Lebanon.1990British
Prime	NP	Prime
Minister	NP	Minister
Margaret	NP	Margaret
Thatcher	NP	Thatcher
,	,	,
having	VHG	have
failed	VVN	fail
to	TO	to
win	VV	win
re-election	NN	re-election
ofthe	NN	ofthe
Conservative	JJ	Conservative
Party	NP	Party
leadership	NN	leadership
on	IN	on
the	DT	the
first	JJ	first
ballot	NN	ballot
,	,	,
announced	VVD	announce
she	PP	she
wouldresign.2006A	NN	wouldresign.2006A
chemical	NN	chemical
factory	NN	factory
explosion	NN	explosion
in	IN	in
Danvers	NP	Danvers
,	,	,
Massachusetts	NP	Massachusetts
,	,	,
destroyed	VVD	destroy
thesurrounding	NN	thesurrounding
neighborhood	NN	neighborhood
but	CC	but
caused	VVD	cause
no	DT	no
deaths	NNS	death
or	CC	or
serious	JJ	serious
injuries.2011Baseball	NN	injuries.2011Baseball
players	NNS	player
and	CC	and
owners	NNS	owner
signed	VVD	sign
an	DT	an
agreement	NN	agreement
for	IN	for
a	DT	a
new	JJ	new
labor	NN	labor
contract	NN	contract
,	,	,
a	DT	a
dealmaking	VVG	dealmak
baseball	NN	baseball
the	DT	the
first	JJ	first
North	JJ	North
American	JJ	American
professional	JJ	professional
major	JJ	major
league	NN	league
to	TO	to
startblood	NN	startblood
testing	NN	testing
on	IN	on
human	JJ	human
growth	NN	growth
hormone	NN	hormone
and	CC	and
expanding	VVG	expand
the	DT	the
playoffs	NNS	playoff
to	TO	to
10	CD	@card@
teams	NNS	team
by2013	NN	by2013
.	SENT	.
Ryan	NP	Ryan
Braun	NP	Braun
was	VBD	be
voted	VVN	vote
the	DT	the
NL	NP	NL
MVP	NP	MVP
after	IN	after
helping	VVG	help
the	DT	the
Milwaukee	NP	Milwaukee
Brewers	NP	Brewers
wintheir	NP	wintheir
first	JJ	first
division	NN	division
title	NN	title
in	IN	in
nearly	RB	nearly
30	CD	@card@
years	NNS	year
.	SENT	.
Death	NN	death
claimed	VVD	claim
France	NP	France
's	POS	's
formerfirst	JJ	formerfirst
lady	NN	lady
Danielle	NP	Danielle
Mitterrand	NP	Mitterrand
at	IN	at
age	NN	age
87	CD	@card@
and	CC	and
Svetlana	NP	Svetlana
Alliluyeva	NP	Alliluyeva
,	,	,
daughter	NN	daughter
ofSoviet	NN	ofSoviet
dictator	NN	dictator
Josef	NP	Josef
Stalin	NP	Stalin
,	,	,
at	IN	at
age	NN	age
85	CD	@card@
.	SENT	.
Soldier-turned-soap	NP	Soldier-turned-soap
opera	NN	opera
star	NN	star
J.	NP	J.
R.	NP	R.
Martinez	NP	Martinez
and	CC	and
his	PP$	his
professional	JJ	professional
partner	NN	partner
,	,	,
Karina	NP	Karina
Smirnoff	NP	Smirnoff
,	,	,
were	VBD	be
named	VVN	name
champions	NNS	champion
ofseason	NN	ofseason
13	CD	@card@
of	IN	of
ABC	NP	ABC
's	POS	's
"	``	"
Dancing	NN	dancing
with	IN	with
the	DT	the
Stars	NP	Stars
.	SENT	.
"	``	"
2015Trying	JJ	2015Trying
to	TO	to
reassure	VV	reassure
a	DT	a
nation	NN	nation
on	IN	on
edge	NN	edge
,	,	,
President	NP	President
Barack	NP	Barack
Obama	NP	Obama
said	VVD	say
in	IN	in
Malaysiathat	NP	Malaysiathat
the	DT	the
Islamic	JJ	Islamic
State	NP	State
group	NN	group
"	``	"
cannot	MD	can
strike	VV	strike
a	DT	a
mortal	JJ	mortal
blow	NN	blow
"	''	"
against	IN	against
the	DT	the
U.	NP	U.
S.	NP	S.
,	,	,
andhe	NN	andhe
warned	VVD	warn
that	IN/that	that
overreacting	VVG	overreact
to	TO	to
the	DT	the
Paris	NP	Paris
attacks	NNS	attack
would	MD	would
play	VV	play
into	IN	into
extremists'hands	NNS	extremists'hands
.	SENT	.
Opposition	NN	opposition
candidate	NN	candidate
Mauricio	NP	Mauricio
Macri	NP	Macri
won	VVD	win
Argentina	NP	Argentina
's	POS	's
presidentialelection	NN	presidentialelection
,	,	,
marking	VVG	mark
an	DT	an
end	NN	end
to	TO	to
the	DT	the
left-leaning	JJ	left-leaning
era	NN	era
of	IN	of
President	NP	President
CristinaFernandez	NP	CristinaFernandez
.	SENT	.
Former	JJ	former
South	NP	South
Korean	NP	Korean
President	NP	President
Kim	NP	Kim
Young-sam	NP	Young-sam
,	,	,
87	CD	@card@
,	,	,
who	WP	who
led	VVD	lead
thecountry	NN	thecountry
's	POS	's
transition	NN	transition
to	TO	to
democracy	NN	democracy
,	,	,
died	VVN	die
in	IN	in
Seoul	NP	Seoul
.	SENT	.
Actress	NN	actress
and	CC	and
artist	NN	artist
AdeleMorales	NP	AdeleMorales
Mailer	NP	Mailer
,	,	,
90	CD	@card@
,	,	,
died	VVN	die
in	IN	in
New	NP	New
York	NP	York
.	SENT	.
Novak	NP	Novak
Djokovic	NP	Djokovic
won	VVD	win
his	PP$	his
fourth	JJ	fourth
straighttitle	NN	straighttitle
at	IN	at
the	DT	the
season-ending	JJ	season-ending
ATP	NP	ATP
finals	NNS	final
by	IN	by
beating	VVG	beat
six-time	JJ	six-time
champion	NN	champion
Roger	NP	Roger
Federer6-3	NP	Federer6-3
,	,	,
6-4	CD	@card@
.	SENT	.
Kyle	NP	Kyle
Busch	NP	Busch
won	VVD	win
his	PP$	his
first	JJ	first
career	NN	career
Sprint	NP	Sprint
Cup	NP	Cup
title	NN	title
claiming	VVG	claim
the	DT	the
seasonfinale	NN	seasonfinale
at	IN	at
Homestead-Miami	NP	Homestead-Miami
Speedway	NP	Speedway
.	SENT	.
One	NP	One
Direction	NP	Direction
won	VVD	win
artist	NN	artist
of	IN	of
the	DT	the
year	NN	year
at	IN	at
theAmerican	NP	theAmerican
Music	NP	Music
Awards	NP	Awards
.	SENT	.
